Contraction	Uncontracted
let's		let_us
i'm			i_am
i'll		i_will
i'd			i_would
i've		i_have
you're		you_are
you'll		you_will
you'd		you_would
you've		you_have
he's		he_is
she's		she_is
he'll		he_will
she'll		she_will
he'd		he_would
she'd		she_would
she's		she_is
he's		he_is
it's		it_is
it'll		it_will
it'd		it_would
we're		we_are
we'll		we_will
we'd		we_would
we've		we_have
they're		they_are
they'll		they_will
they'd		they_would
they've		they_have
there's		there_is
there'll	there_will
there'd		there_would
that's		that_is
that'll		that_will
that'd		that_would
doesn't		does_not
isn't		is_not
needn't		need_not
wasn't		was_not
weren't		were_not
won't		will_not
didn't		did_not
aren't		are_not
should've	should_have
could've	could_have
would've	would_have
shouldn't	should_not
couldn't	could_not
wouldn't	would_not
don't		do_not
musn't		must_not
mustn't		must_not
haven't		have_not
hadn't		had_not
hasn't		has_not
can't		cannot
shan't		shall_not
